an = an
anbiet = an b i t
andrückt = an d r ü k t
anfahr = an f a r
angeb = an g e b
anhör = an h ö r
anlehn = an l e n
anreg = an r e g
ansetz = an s e z
artikeln = a r t i k e l n
belieferung = b e l i f ung
benötig = b e n ö t ig
besprochen = b e sp r o ch
da = da
dass = das
dem = dem
den = den
dieses = dis
direkt = d i r e k t
ein = ein
einem = ein
einschaltung = ein sch a l t ung
er = er
erbet = er b e t
erdrückt = er d r ü k t
erfahr = er f a r
ergeb = er g e b
erhör = er h ö r
erklärte = er k l ä r t e
erleg = er l e g
errat = er r a t
ersetz = er s e z
firma = f schaft
gebet = ge b e t
geehrter = ge e r t
genannt = ge n a nt
genommen = ge n o m e n
geschäft = ge sch ä f t
haben = 3h e n
herr = h
ihn = i n
ihnen = i n
ihr = i r
ihre = i r e
in = i n
interessier = i nt e r e s i r
ist = ist
kenntnis = k e nt n i s
kund = k u nd
mit = mit
mitbring = mit b r i ng
mitdenk = mit d e nk
mitfahr = mit f a r
mitgeb = mit g e b
mithör = mit h ö r
mitliefer = mit l i f e r
mitrat = mit r a t
mitsetz = mit s e z
nicht = nicht
schneider = sch n ei d e r
schwierigkeiten = sch w i r keit n
sehr = s e r
setzen = s e z
sich = sich
sind = sind
termin = t e r m i n
und = und
uns = uns
unserer = uns
verbindung = ver b I nd ung
von = von
wir = wir
zu = zu
